######################################################################################
#                                                                                    #
#                                                                                    #
#  ?                                                                                 #
#                  ?                                                                 #
#                                                                                    #
#           ####                                                                     #
# ?                                                                         !        #
#       #########                                                      #######       #
#                                                                                    #
######################################################################################