############################   ###########################
#                          #   #                         #
#                          #   #                      !  #
#  ?                                               ######
#                  ?                           #X  #     #
#  000         X           #   #               #####     #
#  OOO      #?##           #   #     #    X#             #
# ?OOO                  ## #   #     #######             #
#UOOOO     #V     X   # X U#   #V      X   X     X    #  #
######  ####################   ###  ######################