############################
#                          #
#                          #
#  ?      V                #
#                  ?       #
#             !            #
#           ####           #
# ?                     ## #
#U         #     U   V# X  #
######  ####################