############################################
#..........................................#
#....?..............####...................#
#.................#########................#
#..........!...............................#
#...........###.............?..........;...#
#........#######...........................#
#......................###.................#
#.....................#####................#
#........?............#####............;...#
#............!.............................#
#.............#########....................#
#......###.................................#
#.....#####.........?.......###............#
#....#######...............#####...........#
#.................###......................#
#................#####.....................#
#........?........#####....................#
#.......................!..................#
#...............###########............;...#
#..........................................#
############################################
