############################
#                          #
#                          #
#  ?                       #
#                  ?       #
#              !           #
#           ####           #
# ?                     ## #
#                          #
######  ####################