############################
#                          #
#                          #
#OOOOOOOOOOOOOOOOOOOOOOV ! #
#OOOOOOOOO?OOOOOOOOOOOO#####
#OOOOOOOOOOOOOOOOOOOOOOOOOO#
#######OOOOOOOOO?OOOOOOOOOO#
#OOOOOOOOOOOOOOOOOOOOOOOOOO#
#UOOOOOOOOO#OOOOOOOOOOOOOOO#
############################
