############################
#..........................#
#.....?....................#
#..........................#
#...............?..........#
#.............!............#
#..........####............#
#..........................#
#......#########...........#
#..........................#
############################