############################
#                          #
#                          #
#  ?     V                 #
# L                ?       #
# M            !           #
#           ####           #
# ?                     ## #
#U         #          #V   #
######  #########U##########