############################
#                          #
#                          #
#  ?      V                #
#                  ?       #
#              !           #
#           ####           #
# ?                     ## #
#U         #     U    #V   #
######  ####################