############################
#                          #
#                          #
#  ?     V                 #
#                  ?       #
#              !           #
#           ####           #
# ?                     ## #
#U         #          #V   #
######  #########U##########