############################   ###########################
#                          #   #                         #
#                          #   #                      !  #
#  ?                                               #######
#                  ?                           #X  #     #
#              X           #OOO#               #####     #
#           #?##           #OOO#     #    X#             #
# ?                     ## #OOO#     #######             #
#U         #V     X   # X U#OOO#V      X   X     X    #  #
######  ####################OOO###  ######################