############################
#                          #
#                          #
#  ?                       #
#                  ?       #
#              !           #
#           ####           #
# ?                     ## #
#          #   K      #    #
######  ####################