#############################################################################
#                                                                           #
#                                                     ?                     #
#  ?                                                                        #
#                  ?                                                        #
#                                      ?                                    #
#           ####                                      ?                     #
# ?                            ###                                 !        #
#       #########                                             #######       #
#                                   #####               ##                  #
#############################################################################
