############################
#                          #
#                          #
#  ?                       #
#                  ?       #
#              !           #
#           ####           #
# ?                        #
#       #########          #
#                          #
############################