############################   ###########################
#                          #   #                         #
#                          #   #                      !  #
#  ?                                               ######
#                  ?                           #X  #     #
#              X           #   #               #####     #
#           #?##           #   #     #    X#             #
# ?                     ## #   #     #######             #
#U         #V     X   # X U#   #V      X   X     X    #  #
######  ####################   ###  ######################