#############################
#                         ###
#    ?                  !   #
#                 ######### #
#           ###             ?
#                      ###  #
#                     ##### #
#        ?            ##### #
#                           #
#             #########     #
#      ###                  #
#     #####         ?       #
#    #######               ##
#                 ###       #
#                #####      #
#############################